
         #########################
         #       #     #       # #
         # ### # # ### # # # # # #
         # #   #   #   # # # #   #
         ### # ##### ### # # #####
         #   #     #     # # #     <--END
         # ####### # ##### # # ###
         # # #     # #   # # #   #
         # # # # ### # # # ##### #
         # #   #   #   # #       #
         # ######### ########### #
         #         # #   #     # #
         ### ### # ### # # ### # #
         #   # # #   # # #   # # #
         # # # # ### # # ##### ###
START-->   # # # # # # #     #   #
         # ### # # # # # ### ### #
         #     #   #   #   #     #
         #########################