
         #########################
         #           #     #     #
         # ########### # # # #####
START-->             # # # #     #
         # ######### # # # ##### #
         # #   #   # # # #   #   #
         # # # # # # # # ### # # #
         # # # # # # # #   # # #   <--END
         # # # ### # # # # # # # #
         # # # #   #   # # #   # #
         # # # # # # ##### #######
         # # # # # #   #   #     #
         # # # # # ##### ####### #
         #   #   #     #         #
         # ########### ###########
         #       #   #     #   # #
         # ##### ### # ### # # # #
         #     #     #   #   #   #
         #########################