
         #########################
         # #       #           # #
START-->   # # ##### # # # ### # #
         # # # #     # # #   # # #
         # # # # # ##### ### # # #
         #   #   # #   #   # #   #
         ######### # # ### # #####
         #       # # #     # #   #
         # # ### # # ### ### # ###
         # #   #   #   #   # #   #
         # ### # ##### ### # ###   <--END
         # #   # # #   #   #     #
         # ### # # # ### # ##### #
         #   # #   #   # #     # #
         ### ######### # ##### ###
         # #     #   # # #   #   #
         # ##### # # ### # ##### #
         #       # #     #       #
         #########################