
         #########################
         #     #             #   #
         # # ### # # # # ##### # #
         # #     # # # #   #   # #
         # # ### # # ##### # ### #
         # #   # # #     # #   # #
         ##### # # ##### # ### # #
         #   # # #     # #     # #
         # ### ####### # ####### #
         #     #       #   #   # #
         # ##### ######### # # ###
         # #   #   #   #   # #   #
         # ### # # # # ##### ### #
         #     # #   #     # #   #
         # ##### ######### # #####
         # #   #   #     # #     #
         # ### # # # ### # #####   <--END
START-->       # #   #   #       #
         #########################