
         #########################
         #     #   #     #       #
         # ### # # # # # ##### ###
         # #   # # # # #     #   #
         # # # # # # # ##### ### #
         # # # # #   #     #     #
         # # ### ####### # ### ###
         # #   # #     # #   #   #
         # # # ### ### # ### ### #
         # # #   # # # #   # #   #
         # # ### # # # ##### # ###
START-->   # #   # # #   #   #   #
         # # # ### # # # # ##### #
         # # #   # # # # #   #   #
         # ####### # ### ### # ###
         # #       #   #     #   #
         # # # ####### #########   <--END
         #   #       #           #
         #########################